BBBBBBBBBBBBBBBBBBBBCBBBBBBBBBBBBBBBBBBBB
BBBCCCCCCCCCCCCCCCCCCCCCBCCCCCBBCCCCCCCBB
BBBCBBBBBBBBBBBBBBBBBBBCBCBBBBBBCBBBBBCBB
BCCCBBBCBBCCCCCCCCCCCBBCBCBBBBBBCCCBCBCBB
BCBCBBBCBBCBBBBBBBBBCBBCBCBBBBBBBBCBCBCBB
BCBCBBBCBBCBBBBBBBBBCBBCCCCCCCCCCCCCCBCBB
BCBCBBBCBBCCCCCCCCBBCBBBBBBBBBBBBBBBCBCBB
BCBCBBBCBBCBBBBBBBBBCBBBBBBBBBBBBBBBCBCBB
BCBCCCCCCCCBBBBBCBBBCBBCCCCCCCCCCCCCCBCBB
BCBCBBBBCBBBCCCCCBBBCBBCBBBBBBBBBCBBBBCBB
BCBCBBBBCBBBBBBBCBBBCBBCCCCCCCBBBCBBBBCBB
BCBCBBBBCBBBBBBBCBBBCBBCBBBBBBBBBCBBBBCBB
BCBCBCCCCCCCCCCCCBBBBBCCCCCCCCBBBBBBBBCBB
BCBCBBBBCBBBBBBBBBBBBBBBBBBBBCCCCCCCCCCCB
BCBBBBBBCBBBBBBBBBBBCCCCCCCCCCBBBBBBCBBBB
BCCCCCCCCCCCCCBBBBBBCBBBBBBBBBBBCBBBCBBBB
BBBBBCBBBBBBBCBBBBBBCBBCCCCCBBBBCBBBCBBBB
BCCCCCBBBCCCCCCCCBBBCBBBBBBCBBBBCBBBCBBBB
BBBBBCBBBBBBBCBBBBCCCCCBBBBCCCCCCBBBCBBBB
BBBBBCBBBCCCCCBCBBCCCCCBBBBBBBCBCBBBCBBBB
CCCCCCBBBCBBBBBCBBCCICCBBBBCCCCCCBBBCCCCC
BCBBBCBBBCCCCBBCBBCCCCCBBBBBBBBBCBBBBBCBB
BCBBBCBBBBBBCBBCBBCCCCCBCCCCCCCCCCCCCCCBB
BCBBBCCCCCCCCCCCCBBBBBBBBBBBBBBBCBBBBBBBB
BCCCBBBBBBBBBBBBCCCCCCCCCCCCCCCCCBBBCBCBB
BCBBBBBBBBBBBCBBCBBBBBBBBBBBBBBBCBBBCBCBB
BCBCCCCCCCCBBCBBCBBBCCCCCCCCCCCCCCBBCBCBB
BCBCiCBBBBCBBCBBCBBBCBBBBBBBBBBBBCBBCBCBB
BCBCCCBBBBCBBCBBCBBBCBBBBCCCCCCBBCBBCBCBB
BCBBBBBBBBCBBCBBCBBBCBBBBCBBBBBBBCCCCBCBB
BCBBBBBBBBCBBCBBCBBBCBBBBCBBBBCCCCBBBBCBB
BCBCCCCCCCCCCCCCCCCCCBCCCCBBBBCBBBBBCBCBB
BCBCBBBBBBBBBBBBBBBBCBBBBCBBBBCCCCCCCBCBB
BCBCBBBCCCCCCCCCBBBBCBBBBCBBBBCBBBBBCBCBB
BCBCBBBCBBBBBBBCCCBBCBBBBCCCCCCBBCBBCBCBB
BCBCBBBCCCCCCCCCBBBBBBBBBBBBBBCBBCBBCCCBB
BCCCBBBBBBBBBBBCBBBBCCCCCCCCCCCBBCBBCBBBB
BBBCBBBBBBBBBBBCBBBBCBCBBBBBBCBBBCBBCBBBB
BBBCCCCCCCCCCCCCBBBBCBCCCCBBBCCCCCCCCBBBB
BBBBBBBBBBBBBBBBBBBBCBBBBBBBBBBBBBBBBBBBB