CCGBCCCCCCCCCCCCCCCCCCCCDDDDDCCCCCCCCBGGGBCCCBCCCCCCCCCCCCCCCCDCCCGGCBCCCCCCCCCCCCCCCCCGCC
CDGBCCCCCCCCCCCCBCCCCCCGCCCCGGGCCCCCCDCGGBCCCCCCCCBCCCCGCCCCCCDDDCGGCCCCCCBBBCCCBCCCCCCCGC
iWWWWWWWWWWWWWWWWWWWWWWWWWWWWWWWWWWWWWWWWWWWWWWWWWWWWWWWWWWWWWWWWWWWWWWWWWWWWWWWWWWWWWWWWi
CCGCCCGCCCCCCBGCCDDGCCCDDCCCCGCCBCCCCGGGCCCCGGCCCBCCCCCCCCGCCCCCCBCCCCCCCCDDDCCCCCBCCCCCCC
CCDCCCBCCCCGBBBCCCCCGCCCCCGGCCCCCCDDCCCCCCCCCCGCCCCCCCGGCCCCGDDCCCCCCCCCCBCCCCCCCCCCCCCCCC

