CCGBCCCCCCCCCCCCCCCCCCCCDDDDDCCCCCCCCBGGGBCCCBCCCCCCCCCCCCCCCCDCCCGGCBCCCCCCCCCCCCCCCCCGCC
CDGBCCCCCCCCCCCCBCCCCCCGCCCCGGGCCCCCCDCGGBCCCCCCCCBCCCCGCCCCCCDDDCGGCCCCCCBBBCCCBCCCCCCCGC
WiWiWiWiWiWiWiWiWiWiWiWiWiWiWiWiWiWiWiWiWiWiWiWiWiWiWiWiWiWiWiWiWiWiWiWiWiWiWiWiWiWiWiWiWi
CCGCCCGCCCCCCBGCCDDGCCCDDCCCCGCCBCCCCGGGCCCCGGCCCBCCCCCCCCGCCCCCCBCCCCCCCCDDDCCCCCBCCCCCCC
CCDCCCBCCCCGBBBCCCCCGCCCCCGGCCCCCCDDCCCCCCCCCCGCCCCCCCGGCCCCGDDCCCCCCCCCCBCCCCCCCCCCCCCCCC

