BBBBBBBBBBBBBBBBBBBBCBBBBBBBBBBBBBBBBBBBB
BBBCCCCCCCCCCCCCCCCCCCCCBBBBBBBBCCCCCCCBB
BBBCBBBBBBBBBBBBBBBBBBBCBBBBBBBBCBBBBBCBB
BBBCBBBBBBCCCCCCCCCCCBBCBBBBBBBBCCCBCBCBB
BBBCBBBBBBCBBBBBBBBBCBBCBBBBBBBBBBCBCBCBB
BBBCBBBBBBCBBBBBBBBBCBBCCCCCCCCCCCCCCBCBB
BBBCBBBBBBCCCCCCCCBBCBBBBBBBBBBBBBBBCBCBB
BBBCBBBBBBCBBBBBBBBBCBBBBBBBBBBBBBBBCBCBB
BBBCCCCCCCCBBBBBCBBBCBBCCCCCCCCCCCCCCBCBB
BBBCBBBBCBBBCCCCCBBBCBBCBBBBBBBBBCBBBBCBB
BBBCBBBBCBBBBBBBCBBBCBBCBBBBBBBBBCBBBBCBB
BBBCBBBBCBBBBBBBCBBBCBBCBBBBBBBBBCBBBBCBB
BBBCBCCCCCCCCCCCCBBBBBCCCCCCCCBBBBBBBBCBB
BBBCBBBBCBBBBBBBBBBBBBBBBBBBBCCCCCCCCCCCB
BBBBBBBBCBBBBBBBBBBBCCCCCCCCCCBBBBBBBBBBB
BBBBBCCCCCCCCCBBBBBBCBBBBBBBBBBBBBBBCBBBB
BBBBBCBBBBBBBCBBBBBBCBBBBBBCBBBBBBBBCBBBB
BBBBBCBBBCCCCCCCCBBBCBBBBBBCBBBBBBBBCBBBB
BBBBBCBBBBBBBCBBBBCCCCCBBBBCCCCCCBBBCBBBB
BBBBBCBBBCCCCCBBBBCCCCCBBBBBBBCBCBBBCBBBB
CCCCCCBBBCBBBBBBBBCCICCBBBBCCCCCCBBBCCCCC
BBBBBCBBBCCCCBBBBBCCCCCBBBBBBBBBCBBBBBCBB
BBBBBCBBBBBBCBBBBBCCCCCBBBBBBBBBCCCCCCCBB
BBBBBCCCCCCCCCCCCBBBBBBBBBBBBBBBCBBBBBBBB
BBBBBBBBBBBBBBBBCCCCCCCCCCCCCCCCCBBBCBBBB
BBBBBBBBBBBBBBBBCBBBBBBBBBBBBBBBCBBBCBBBB
BBBCCCCCCCCBBBBBCBBBCCCCCCCCCCCCCCBBCBBBB
BBBCiCBBBBCBBBBBCBBBCBBBBBBBBBBBBCBBCBBBB
BBBCCCBBBBCBBBBBCBBBCBBBBCCCCCCBBCBBCBBBB
BBBBBBBBBBCBBBBBCBBBCBBBBCBBBBBBBCCCCBBBB
BBBBBBBBBBCBBBBBCBBBCBBBBCBBBBCCCCBBBBBBB
BBBCCCCCCCCCCCCCCCCCCBCCCCBBBBCBBBBBCBBBB
BBBCBBBBBBBBBBBBBBBBCBBBBCBBBBCCCCCCCBBBB
BBBCBBBCCCCCCCCCBBBBCBBBBCBBBBCBBBBBCBBBB
BBBCBBBCBBBBBBBCCCBBCBBBBCCCCCCBBCBBCBBBB
BBBCBBBCCCCCCCCCBBBBBBBBBBBBBBCBBCBBCBBBB
BBBCBBBBBBBBBBBCBBBBCCCCCCCCCCCBBCBBCBBBB
BBBCBBBBBBBBBBBCBBBBCBCBBBBBBCBBBCBBCBBBB
BBBCCCCCCCCCCCCCBBBBCBCCCCBBBCCCCCCCCBBBB
BBBBBBBBBBBBBBBBBBBBCBBBBBBBBBBBBBBBBBBBB