CCGBCCCCCCCCCCCCCCCCCCCCDDDDDCCCCCCCCBGGGBCCCBCCCCCCCCCCCCCCCCDCCCGGCBCCCCCCCCCCCCCCCCCGCC
CDGBCCCCCCCCCCCCBCCCCCCGCCCCGGGCCCCCCDCGGBCCCCCCCCBCCCCGCCCCCCDDDCGGCCCCCCBBBCCCBCCCCCCCGC
CCCBCCCCBGCCCCGCCGCCCCCCCCBBBGCCCCCDCCCCCCCCCCCCGGCCGGGBGCCCCCCDDCCGCCGCCCGCCCCCCCCCCCCCGC
CCGCCCGCCCCCCBGCCDDGCCCDDCCCCGCCBCCCCGGGCCCCGGCCCBCCCCCCCCGCCCCCCBCCCCCCCCDDDCCCCCBCCCCCCC
CCDCCCBCCCCGBBBCCCCCGCCCCCGGCCCCCCDDCCCCCCCCCCGCCCCCCCGGCCCCGDDCCCCCCCCCCBCCCCCCCCCCCCCCCC

