CCGBCCCCCCCCCCCCCCCCCCCCDDDDDCCCCCCCCBGGGBCCCBCCCCCCCCCCCCCCCCDCCCGGCBCCCCCCCCCCCCCCCCCGCC
CDGBCCCCCCCCCCCCBCCCCCCGCCCCGGGCCCCCCDCGGBCCCCCCCCBCCCCGCCCCCCDDDCGGCCCCCCBBBCCCBCCCCCCCGC
WWWWWWWWWWWWWWWWWWWWWWWWWWWWWWWWWWWWWWWWWWWWWWWWWWWWWWWWWWWWWWWWWWWWWWWWWWWWWWWWWWWWWWWWWW
CCGCCCGCCCCCCBGCCDDGCCCDDCCCCGCCBCCCCGGGCCCCGGCCCBCCCCCCCCGCCCCCCBCCCCCCCCDDDCCCCCBCCCCCCC
CCDCCCBCCCCGBBBCCCCCGCCCCCGGCCCCCCDDCCCCCCCCCCGCCCCCCCGGCCCCGDDCCCCCCCCCCBCCCCCCCCCCCCCCCC

